veux savoir	{vouloir}
veux tous	{vouloir}
veux	{vouloir}
quel est	{vouloir}
quels sont	{vouloir}
quelle est	{vouloir}
quelles sont	{vouloir}
quels	{vouloir}
quelles	{vouloir}
quelle	{vouloir}
quel	{vouloir}
comment	{vouloir}
donnez-moi	{vouloir}
voudrais	{vouloir}
aimerais	{vouloir}
donne-moi	{vouloir}
donnent	{vouloir}
veut	{vouloir}
veux	{vouloir}


combien fois	{vouloir nombre}
combien	{vouloir nombre}
nombre	{nombre}

est-il	{existance}
y-a-t-il	{existance}

articles	{article}
article	{article}
auteurs	{auteur}
auteur	{auteur}
ecrit par	{auteur}
ecrit le	{parus}
publie par	{auteur}
publie le	{parus}
pages	{page}
page	{page}
portant sur	{theme}
