À 	À 
à 	à 
a 	a 
abordé 	abordé
abordés 	abordé
accident 	accident
accidents 	accident
actions 	acti
activités 	acti
adresse 	adresse
adresses 	adresse
afghanistan 	afghanistan 
afp 	afp 
afrique 	afrique 
agriculture 	agriculture 
aimerais 	aimerais 
al 	al 
allé 	allé 
allemagne 	allemagne 
américaine 	américaine 
ancien 	ancien
ancienne 	ancien
angeles 	angeles 
année 	année 
aout 	aout 
apparaissent 	appar
apparait 	appar
apparition 	appar
apparraissent 	appar
apparu 	appar
apparus 	appar
apparut 	appar
ariel 	ariel 
aériens 	aériens 
article 	article
articlent 	article
articles 	article
articules 	artic
assad 	assad 
associés 	associés 
attentat 	attentat
attentats 	attentat
au 	au 
aubenas 	aube
aubert 	aube
aujourd 	aujourd 
aussi 	aussi 
auteur 	auteur
auteurs 	auteur
autre 	autre 
aux 	aux 
avec 	avec 
avril 	avril 
ayant 	ayant 
bachar 	bachar 
baghdad 	baghdad 
barack 	barack 
bas 	bas 
belgique.je 	belgique.je 
ben 	ben 
berlusconi 	berlusconi 
betancourt 	betancourt 
blair 	blair 
bolivie 	bolivie 
breve 	breve 
bréves 	bréves 
bush 	bush 
capture 	capture 
castro 	castro 
catastrophe 	catastrophe 
catholicisme 	catholicisme 
ce 	ce 
celui 	celui 
censure 	censure 
ces 	ces 
chaque 	chaque 
chiite 	chiite 
chine 	chine 
chirac 	chirac 
ci 	ci 
cisjordanie 	cisjordanie 
cité 	cité
cités 	cité
climatiques 	climatiques 
colons 	colons 
combien 	combien 
comment 	comment 
compagne 	compagne 
concernant 	concern
concernent 	concern
conclave 	conclave 
conflit 	conflit 
connaitre 	connaitre 
économie 	économi
économique 	économi
consulter 	consulter 
contacter 	contacter 
contenant 	conten
contenus 	conten
contient 	contient 
corée 	corée 
corpus 	corpus 
corriez 	corriez 
cour 	cour 
écris 	écris 
crise 	crise 
écrit 	écrit
écrits 	écrit
cyclone 	cyclone
cyclones 	cyclone
d 	d 
dans 	dans 
datant 	datant 
date 	date 
dates 	dates 
david 	david 
début 	début 
décembre 	décembre 
de 	de 
debre 	debre 
depuis 	depuis 
dernier 	dernier
derniers 	dernier
dernière 	derni
des 	des 
défense 	défense 
différentes 	différent
différents 	différent
disque 	disque 
domaine 	domaine 
donné 	donné 
donne 	donne 
donner 	donner 
donnez 	donnez 
dont 	dont 
droits 	droits 
déroulés 	déroulés 
du 	du 
éducation 	éducation 
durant 	durant 
e 	e 
el 	el 
elle 	elle 
email 	email 
en 	en 
enfants 	enfants 
enlèvement 	enlèvement 
ensemble 	ensemble 
entre 	entre 
est 	est 
et 	et 
etats 	etats 
eu 	eu 
euthanasie 	euthanasie 
existe 	existe 
expliquer 	expliquer 
fa 	fa 
fabrice 	fabrice 
fait 	fait 
fascisme 	fascisme 
fidel 	fidel 
film 	film 
fin 	fin 
florence 	florence 
focus 	focus 
fois 	fois 
font 	font 
française 	fran
france 	fran
franceet 	fran
franck 	fran
fusillades 	fusillades 
février 	février 
gaza 	gaza 
george 	george 
ghaza 	ghaza 
gigantesque 	gigantesque 
grand 	grand
grands 	grand
gros 	gros
grostitre 	gros
guantanamo 	guantanamo 
guerre 	guerre 
guillaume 	guillaume 
hervé 	hervé 
hiver 	hiver 
homme 	homme 
homosexualité 	homosexualité 
hui 	hui 
humanitaires 	humanitaires 
hussein 	hussein 
ii 	ii 
il 	il 
ils 	ils 
improbable 	improbable 
industrie 	industrie 
informations 	informations 
ingrid 	ingrid 
intervenu 	intervenu 
intitulé 	intitulé 
irak 	irak 
israel 	israel
israelo 	israel
italie 	italie 
j 	j 
jackson 	jackson 
jacques 	jacques 
janvier 	janvier 
japon 	japon 
je 	je 
jean 	jean 
jo 	jo 
jordanie 	jordanie 
jour 	jour
journée 	jour
jours 	jour
juge 	juge 
juillet 	juillet 
juin 	juin 
justice 	justice 
kamikaze 	kamikaze 
katrina 	katrina 
kidnappé 	kidnappé 
l 	l 
la 	la 
laden 	laden 
laquelle 	laquelle 
le 	le 
élection 	élect
électricité 	élect
lefebvre 	lefebvre 
les 	les 
lesquels 	lesquels 
les_rappels 	les_rappels 
leur 	leur
leurs 	leur
liban 	liban 
libération 	libération 
liens 	liens 
liés 	liés 
liste 	liste 
los 	los 
mail 	mail 
mails 	mails 
mais 	mais 
mars 	mars 
meme 	meme 
menace 	menace 
mentionné 	mentionn
mentionne 	mentionn
michael 	michael 
micheal 	micheal 
michel 	michel 
mickael 	mickael 
mme 	mme 
même 	même 
mohamet 	mohamet 
moi 	moi 
moins 	moins 
mois 	mois 
mondiale 	mondiale 
mort 	mort 
mot 	mot 
mots 	mots 
moustache 	moustache 
moyen 	moyen
moyenne 	moyen
météorologiques 	météorologiques 
n 	n 
news 	news 
nicolas 	nicolas 
no 	no 
nombre 	nombre 
non 	non 
nouvelle 	nouvelle 
où 	où 
obama 	obama 
octobre 	octobre 
olivier 	olivier 
on 	on 
ont 	ont 
opposé 	opposé 
opération 	opération 
ordre 	ordre 
orient 	orient 
otages 	otages 
ou 	ou 
page 	page
pages 	page
palestine 	palestin
palestinien 	palestin
panne 	panne 
pape 	pape 
par 	par 
paris 	paris 
parlé 	parlé 
parlait 	parlait 
parlant 	parlant 
parle 	parle 
parlent 	parlent 
parmi 	parmi 
parrus 	parrus 
partir 	partir 
paru 	paru 
parue 	parue 
parus 	parus 
parution 	parution 
pas 	pas 
paul 	paul 
pays 	pays 
pendant 	pendant 
photos 	photos 
plus 	plus
plusieurs 	plus
politique 	politique 
pop 	pop 
portant 	port
porte 	port
portent 	port
possédant 	possédant 
pour 	pour 
pourcentage 	pourcentage 
poutine 	poutine 
pouvoir 	pouvoir 
pqges 	pqges 
premier 	premier
premiers 	premier
période 	période 
proche 	proche 
procès 	procès 
procés 	procés 
procs 	procs 
proportion 	propo
propos 	propo
proviennent 	proviennent 
présent 	prés
présidence 	présiden
président 	présiden
présidentielle 	présiden
publié 	publié 
pubs 	pubs 
puis 	puis 
qaïda 	qaïda 
qaida 	qaida 
quand 	quand 
que 	que 
quel 	quel 
quelle 	quelle
quelles 	quelle
quels 	quels 
qui 	qui 
quoi 	quoi 
rappels 	rapp
rapport 	rapp
récent 	récent
récente 	récent
récurrent 	récurrent 
rédigés 	rédigés 
relatifs 	relati
relation 	relati
religion 	religion 
rencontre 	rencontre 
reparle 	reparle 
retourner 	retourner 
réference 	réference 
référence 	référen
référendum 	référen
routier 	routier 
royaume 	royaume 
résumé 	résumé
résumés 	résumé
rubrique 	rubrique 
russie 	russie 
s 	s 
saddam 	saddam 
santée 	santée 
sarkozy 	sarkozy 
savoir 	savoir 
schroeder 	schroeder 
se 	se 
section 	section
sections 	section
semaines 	semaines 
septembre 	septembre 
sharon 	sharon 
silvio 	silvio 
smoking 	smoking 
sénégal 	sénégal 
sont 	sont 
souhaiterais 	souhaiterais 
souvent 	souvent 
star 	star 
straus 	straus 
successifs 	successi
successivement 	successi
sujet 	sujet
sujets 	sujet
sur 	sur 
survenu 	survenu 
t 	t 
été 	été 
étant 	étant 
états 	états 
temps 	temps 
terme 	terme 
terrorisme 	terroris
terroriste 	terroris
textes 	textes 
theme 	theme 
théme 	théme 
thème 	thème
thèmes 	thème
thémes 	thémes 
téhéran 	téhéran 
titre 	titre
titres 	titre
tony 	tony 
tous 	tous 
toutes 	toutes 
traité 	trait
traitant 	trait
traitants 	trait
traite 	trait
traitent 	trait
traités 	trait
étrangére 	étrangére 
travaillés 	travaillés 
trouvent 	trouvent 
ue 	ue 
un 	un 
une 	une 
unes 	unes 
uni 	uni 
unis 	unis 
usa 	usa 
va 	va 
vatican 	vatican 
éventuellement 	éventuellement 
vers 	vers 
veux 	veux 
visites 	visites 
vladimir 	vladimir 
événements 	événements 
voirs 	voirs 
évoque 	évoque 
voudrais 	voudrais 
washington 	washington 
wbush 	wbush 
w.bush 	w.bush 
y 	y 
